1111111111111111111111111111111111111
1000000000000000000000000000000000001
100000000000000P000200000000000000001
1000000000000000000000000000000000001
1000000000000000000000000000000000001
1000001100000001100000000110000000001
1000000000000000000000000000000000001
1000000000001000000000010000000000001
1000000000001000000000010000000000001
1000000000001000000000010000000000001
1000000000000000000000000000000000001
1000000000000000000000000000000000001
1000000000000000000000000000000000001
1000000000000000000000000000000000001
1000000000000000000000000000000000001
1000000000000000000000000000000000001
1000000000000000000000000000000000001
1000000000000000000000000000000000001
1000000000000000000000000000000000001
1000000000000000000000000000000000001
1000000000000000000000000000000000001
1000000000000000000000000000000000001
1000000000000000011110000000000000001
1000000000000000000000000000000000001
1000000000000000000001111110000000001
1000000000000000000000000000000000001
1000011111100000000000000000000000001
1000000000000000000000000000000000001
1000000000000000000000000000000000001
1111111111111111111111111111111111111